####......................
....######################
..........................
..........................
...............####.......
@........######...........
###########..........#####